ID,c0,c1,c2,c3,c4,c5,c6,c7,c8,c9,c10,c11,c12,ruleCount,grid0,gridType0
9999,10,13,0,0,0,0,0,0,0,0,0,0,0,"2,1",,
0,2,2,2,2,2,2,1,4,4,4,4,1,1,,"3,0","1"
1,2,15,4,1,1,1,1,1,1,2,4,4,15,,"6,12","2"
2,15,8,4,1,2,4,1,15,2,2,4,2,2,,,
3,1,1,1,1,2,4,1,4,4,4,4,4,2,,,
4,1,2,2,2,2,15,1,4,2,2,2,2,2,,,
5,15,2,8,8,8,4,1,2,2,2,8,15,8,,,
6,1,2,15,4,4,4,1,2,1,1,1,1,1,,,
7,1,1,1,1,1,1,1,4,1,2,2,2,2,,,
8,2,1,2,1,15,4,4,4,1,1,1,15,1,,,
9,2,15,2,1,1,1,1,1,1,2,2,2,2,,,
