ID,c0,c1,c2,c3,c4,c5,c6,c7,c8,c9
9999,13,10,0,0,0,0,0,0,0,0
0,2,2,2,2,2,2,2,2,2,-1
1,2,-1,4,2,2,1,1,1,2,4
2,1,1,1,2,-1,1,4,1,2,4
3,-1,2,1,2,2,1,4,1,2,4
4,2,2,1,2,-1,1,4,1,2,4
5,2,-1,1,1,1,1,4,1,2,2
6,2,4,4,4,4,4,4,1,4,-1
7,2,2,2,2,2,-1,4,1,4,4
8,2,2,1,1,1,1,1,1,4,2
9,-1,2,1,4,4,4,4,4,4,-1
10,4,2,1,1,1,1,1,1,-1,2
11,4,2,2,2,2,2,2,1,4,2
12,4,2,-1,4,4,4,-1,1,1,1
