ID,c0,c1,c2,c3,c4,c5,c6,c7,c8,c9,c10,c11,c12
9999,10,13,0,0,0,0,0,0,0,0,0,0,0
0,2,2,2,8,8,15,8,8,8,8,8,8,8
1,2,2,1,15,1,1,2,2,15,8,8,8,8
2,2,15,1,8,2,1,8,8,15,2,8,2,8
3,1,1,1,8,2,1,1,1,15,1,1,1,1
4,1,15,1,8,2,1,8,8,15,2,2,2,2
5,2,2,2,8,8,15,8,8,15,1,1,1,1
6,2,1,15,1,1,1,8,8,15,8,1,1,1
7,2,1,2,2,2,2,2,2,15,2,2,2,2
8,2,1,1,1,1,1,1,1,15,2,4,4,4
9,2,1,8,8,8,8,8,8,8,8,8,2,2
